NO textures/wonderland/wonderland_wall_north.xpm
SO textures/wonderland/wonderland_wall_south.xpm
WE textures/wonderland/wonderland_wall_west.xpm
EA textures/wonderland/wonderland_wall_east.xpm
F 139,69,19
C 135, 206, 235

1111111
1000001
1000001
1001001
1000001
10N0001
1111111
