F 128,128,128
C 128,128,128
NO textures/wolfenstein/blue_stone.xpm
SO textures/wolfenstein/purple_stone.xpm
WE textures/wolfenstein/grey_stone.xpm
EA textures/wolfenstein/eagle.xpm




1111111
1000001
1000001
1N00001
1111111






